Ackermannviridae	dsDNA
Adenoviridae	dsDNA
Adomaviridae	dsDNA
Alloherpesviridae	dsDNA
Alphaflexiviridae	+ssRNA
Alphasatellitidae	ssDNA-satellite
Alphatetraviridae	+ssRNA
Alvernaviridae	+ssRNA
Amalgaviridae	dsRNA
Amnoonviridae	-ssRNA
Ampullaviridae	dsDNA
Anelloviridae	ssDNA
Arenaviridae	-ssRNA
Arteriviridae	+ssRNA
Ascoviridae	dsDNA
Asfarviridae	dsDNA
Aspiviridae	-ssRNA
Astroviridae	+ssRNA 
Autolykiviridae	dsDNA
Bacilladnaviridae	ssDNA
Baculoviridae	dsDNA
Barnaviridae	+ssRNA
Benyviridae	+ssRNA
Betaflexiviridae	+ssRNA
Bicaudaviridae	dsDNA
Bidnaviridae	ssDNA
Birnaviridae	dsRNA
Bornaviridae	-ssRNA
Bromoviridae	+ssRNA
Caliciviridae	+ssRNA
Carmotetraviridae	+ssRNA
Caulimoviridae	dsDNA-RT
Chrysoviridae	dsRNA
Chuviridae	-ssRNA
Circoviridae	ssDNA
Clavaviridae	dsDNA
Closteroviridae	+ssRNA
Coronaviridae	+ssRNA
Corticoviridae	dsDNA
Cruciviridae	ssDNA
Cruliviridae	-ssRNA
Cystoviridae	dsRNA
Deltaflexiviridae	+ssRNA
Dicistroviridae	+ssRNA
Endornaviridae	dsRNA
Euroniviridae	+ssRNA
Filoviridae	-ssRNA
Fimoviridae	-ssRNA
Flaviviridae	+ssRNA
Flexiviridae	+ssRNA
Fusariviridae	+ssRNA
Fuselloviridae	dsDNA
Gammaflexiviridae	+ssRNA
Geminiviridae	ssDNA
Genomoviridae	ssDNA
Globuloviridae	dsDNA
Guttaviridae	dsDNA
Hantaviridae	-ssRNA
Hepadnaviridae	dsDNA-RT
Hepeviridae	+ssRNA
Herpesviridae	dsDNA
Hypoviridae	dsRNA
Hytrosaviridae	dsDNA
Iflaviridae	ssRNA
Inoviridae	ssDNA
Iridoviridae	dsDNA
Lavidaviridae	dsDNA
Leviviridae	+ssRNA
Lipothrixviridae	dsDNA
Luteoviridae	+ssRNA
Malacoherpesviridae	dsDNA
Marnaviridae	+ssRNA
Marseilleviridae	dsDNA
Medioniviridae	+ssRNA
Megabirnaviridae	dsRNA
Mesoniviridae	+ssRNA
Metaviridae	ssRNA-RT
Microviridae	+ssRNA
Mimiviridae	dsDNA
Mononiviridae	+ssRNA
Mymonaviridae	-ssRNA
Myoviridae	dsDNA
Mypoviridae	-ssRNA
Nairoviridae	-ssRNA
Nanoviridae	ssDNA
Narnaviridae	+ssRNA
Nimaviridae	dsDNA
Nodaviridae	+ssRNA
Nudiviridae	dsDNA
Nyamiviridae	-ssRNA
Orthomyxoviridae	-ssRNA
Papillomaviridae	dsDNA
Paramyxoviridae	-ssRNA
Partitiviridae	dsRNA
Parvoviridae	ssDNA
Peribunyaviridae	-ssRNA
Bunyaviridae	-ssRNA
Permutotetraviridae	+ssRNA
Phasmaviridae	-ssRNA
Phenuiviridae	-ssRNA
Phycodnaviridae	dsDNA
Picobirnaviridae	dsRNA
Picornaviridae	+ssRNA
Pithoviridae	dsDNA
Plasmaviridae	dsDNA
Pleolipoviridae	ssDNA
Pneumoviridae	-ssRNA
Podoviridae	dsDNA
Polycipiviridae	+ssRNA
Polydnaviridae	dsDNA
Polyomaviridae	dsDNA
Portogloboviridae	dsDNA
Potyviridae	+ssRNA
Poxviridae	dsDNA
Qinviridae	-ssRNA
Quadriviridae	dsRNA
Reoviridae	dsRNA
Retroviridae	ssRNA-RT
Rhabdoviridae	-ssRNA
Roniviridae	+ssRNA
Rudiviridae	dsDNA
Sarthroviridae	+ssRNA
Secoviridae	+ssRNA
Siphoviridae	dsDNA
Smacoviridae	ssDNA
Solemoviridae	+ssRNA
Solinviviridae	+ssRNA
Sphaerolipoviridae	dsDNA
Sphaeromadae	+ssRNA
Spiraviridae	ssDNA
Sunviridae	-ssRNA
Tectiviridae	dsDNA
Tobaniviridae	+ssRNA
Togaviridae	+ssRNA
Tolecusatellitidae	ssDNA-satellite
Tombusviridae	+ssRNA
Totiviridae	dsRNA
Tristromaviridae	dsDNA
Turriviridae	dsDNA
Tymoviridae	+ssRNA
Unclassified	Unknown
Virgaviridae	+ssRNA
Wupedeviridae	-ssRNA
Yueviridae	-ssRNA